0 0 0 0 0 0 0 0 0 0 0 0 0 0 0 0 0 0 0 0 0 0 0 0 0 0 0 0 0 0 0 0 0 0 0 0 0 0 0 0 0 0 0 0 0 0 0 0 0 0 
0 0 0 0 0 0 0 0 0 0 0 0 0 0 0 0 0 0 0 0 0 0 0 0 0 0 0 0 0 0 0 0 0 0 0 0 0 0 0 0 0 0 0 0 0 0 0 0 0 0 
0 0 0 0 1 2 0 0 0 0 0 0 0 0 0 0 0 0 0 0 0 0 0 0 0 0 0 0 0 0 0 0 0 0 0 0 1 2 1 2 1 2 1 2 1 0 0 0 0 0 
0 0 0 0 2 1 0 0 0 0 0 0 0 0 0 0 0 0 0 0 2 1 2 1 2 1 2 1 2 1 2 1 0 0 0 0 2 1 2 1 2 1 2 1 2 0 0 0 0 0 
1 2 0 0 0 2 1 2 0 0 0 0 0 2 1 0 0 0 0 0 1 2 1 2 1 2 1 2 1 2 3 3 0 0 0 0 0 0 0 0 0 0 0 3 3 0 1 2 1 2 
2 1 0 0 0 1 2 1 0 0 0 0 0 1 2 0 0 0 0 0 0 0 0 0 0 0 0 0 0 0 3 3 0 0 0 0 0 0 0 0 0 0 0 3 3 0 2 1 2 1 
0 2 1 2 1 2 0 0 0 0 0 0 0 2 1 0 0 0 0 0 0 0 0 0 0 0 0 0 0 0 0 0 0 0 2 1 2 1 2 0 0 0 0 3 3 2 1 2 0 0 
0 1 2 1 2 1 0 0 0 0 0 0 0 1 2 1 2 0 0 0 2 1 0 0 0 0 0 0 0 0 0 0 0 0 1 2 1 2 1 0 0 0 0 3 3 1 2 1 0 0 
0 2 1 2 1 2 0 0 1 2 1 2 1 2 1 2 1 0 0 0 1 2 0 0 1 2 1 2 0 0 3 3 3 3 3 1 2 1 2 1 2 0 0 0 0 0 0 0 0 0 
0 0 0 0 0 1 0 0 2 1 2 1 2 1 2 0 0 0 0 0 0 0 0 0 2 1 2 1 0 0 3 3 3 3 3 2 1 2 1 2 1 0 0 0 0 0 0 0 0 0 
0 0 5 5 5 5 5 5 5 5 5 0 0 2 1 0 0 0 0 0 0 0 0 0 0 2 1 0 0 0 2 1 2 1 2 1 0 0 3 3 3 3 0 0 0 5 5 5 5 5 
0 0 5 5 5 5 5 5 5 5 5 0 0 1 2 1 2 1 2 1 2 1 2 1 2 1 2 0 0 0 1 2 1 2 1 2 0 0 3 3 3 3 0 0 0 5 5 5 5 5 
0 0 5 5 5 5 5 5 5 5 5 0 0 2 1 2 1 2 1 2 1 2 1 2 1 2 1 0 0 0 4 4 4 4 4 4 4 4 4 4 4 4 0 0 0 5 5 5 5 5 
0 0 5 5 5 5 5 5 5 5 5 0 0 1 2 0 0 0 0 0 0 0 0 0 0 0 0 0 0 0 4 4 4 4 4 4 4 4 4 4 4 4 0 0 0 5 5 5 5 5 
0 0 0 0 0 1 2 1 2 1 2 3 3 3 3 3 1 2 0 0 0 0 0 0 0 0 0 0 0 0 4 4 4 4 4 4 4 4 4 4 4 4 2 1 2 5 5 5 5 5 
0 0 0 0 0 2 1 2 1 2 1 3 3 3 3 3 2 1 0 0 0 0 0 0 0 0 0 0 0 0 4 4 4 4 4 4 4 4 4 4 4 4 1 2 1 5 5 5 5 5 
0 0 0 0 0 0 0 0 0 0 0 0 0 0 0 0 1 2 0 0 3 3 3 3 3 3 3 3 3 3 4 4 4 4 4 4 4 4 4 4 4 4 2 1 2 5 5 5 5 5 
0 0 0 0 0 0 0 0 0 0 0 0 0 0 0 0 2 1 0 0 3 3 3 3 3 3 3 3 3 3 2 1 2 1 2 4 4 4 4 4 4 4 1 2 1 5 5 5 5 5 
3 3 3 3 3 3 2 1 2 1 2 0 0 0 0 0 0 0 0 0 0 0 2 1 0 0 0 0 0 0 1 2 1 2 1 4 4 4 4 4 4 4 2 1 2 0 0 0 0 0 
3 3 4 4 4 4 4 4 4 4 4 4 4 4 4 4 4 4 0 0 0 0 1 2 0 0 0 0 0 0 0 0 0 0 0 0 0 3 3 0 0 0 1 2 1 0 0 0 0 0 
0 4 4 4 4 4 4 4 4 4 4 4 4 4 4 4 4 4 0 0 0 0 2 1 0 0 0 0 0 0 0 0 0 0 0 0 0 3 3 0 0 0 2 1 2 0 0 0 0 0 
0 4 4 4 4 4 4 4 4 4 4 4 4 4 4 4 4 4 0 0 0 0 1 2 1 2 1 2 1 2 3 3 3 3 3 0 0 3 3 0 0 0 1 2 1 0 0 0 0 0 
0 4 4 4 4 4 4 4 4 4 4 4 4 4 4 4 4 4 0 0 0 0 2 1 2 1 2 1 2 1 3 3 3 3 3 0 0 3 3 1 2 1 2 1 2 1 2 1 2 1 
0 4 4 4 4 4 4 4 4 4 4 4 4 4 4 4 4 4 0 0 0 0 1 2 0 0 0 0 0 0 0 0 0 0 0 0 0 3 3 2 1 2 1 2 1 2 1 2 1 2 
0 4 4 4 4 4 4 4 4 4 4 4 4 4 4 4 4 4 0 0 0 0 0 0 0 0 0 0 0 0 0 0 0 0 0 0 0 0 0 0 0 0 0 0 0 0 0 0 0 0 
0 0 0 0 0 0 0 0 0 0 0 0 0 0 0 0 0 0 0 0 0 0 0 0 0 0 0 0 0 0 0 0 0 0 0 0 0 0 0 0 0 0 0 0 0 0 0 0 0 0 
0 0 1 0 0 0 0 0 0 0 0 0 1 0 0 0 0 0 0 0 0 0 0 0 0 0 0 0 0 0 0 0 0 0 0 0 0 1 0 0 0 0 0 0 0 0 0 1 0 0 
0 0 2 1 2 1 2 1 2 1 2 1 2 0 0 0 0 0 0 0 0 0 0 0 0 0 0 0 0 0 0 0 0 0 0 0 0 2 1 2 1 2 1 2 1 2 1 2 0 0 
0 0 1 0 0 2 0 0 0 2 0 0 1 0 0 0 0 0 0 0 0 0 0 1 2 1 2 0 0 0 0 0 0 0 0 0 0 1 0 0 2 0 0 0 2 0 0 1 0 0 
0 0 2 1 2 1 2 1 2 1 2 1 2 0 0 0 0 0 0 0 0 0 0 2 7 8 1 0 0 0 0 0 0 0 0 0 0 2 1 2 1 2 1 2 1 2 1 2 0 0 
0 0 1 2 1 2 1 2 1 2 1 2 1 0 0 0 0 0 0 0 0 0 0 1 9 10 2 0 0 0 0 0 0 0 0 0 0 1 2 1 2 1 2 1 2 1 2 1 0 0