0 0 0 0 0 0 0 0 0 0 0 0 0 0 0 0 0 0 0 0 0 0 0 0 0 0 0 0 0 0 0 0 0 0 0 0 0 0 0 0 0 0 0 0 0 0 0 0 0 0
0 0 0 0 0 0 0 0 0 0 0 0 0 0 0 0 0 0 0 0 0 0 0 0 0 0 0 0 0 0 0 0 0 0 0 0 0 0 0 0 0 0 0 0 0 0 0 0 0 0
0 0 0 0 0 0 0 0 0 0 0 0 0 0 0 0 0 0 0 0 0 0 0 0 0 0 0 0 0 0 0 0 0 0 0 0 0 0 0 0 0 0 0 0 0 0 0 0 0 0
0 0 0 0 0 1 2 0 0 0 0 0 0 0 0 0 0 0 0 0 0 0 0 0 0 0 0 0 0 0 0 1 2 0 0 0 0 0 0 0 0 0 4 0 0 0 0 0 0 0
0 0 0 0 0 2 1 0 0 0 0 0 0 0 0 0 0 0 0 0 0 0 0 0 0 0 0 0 0 0 0 2 1 0 0 0 0 0 0 0 4 4 4 0 0 0 4 4 0 0
0 0 2 1 2 1 2 1 2 1 0 0 0 0 0 0 0 0 0 0 0 0 0 0 0 0 0 0 2 1 2 1 2 1 2 1 0 0 0 4 4 4 4 4 4 4 4 4 4 0
0 0 1 2 1 2 1 2 1 2 4 4 4 4 4 4 4 4 4 4 4 4 4 4 4 4 4 4 1 2 1 2 1 2 1 2 0 0 0 4 4 4 4 4 4 4 4 4 4 4
4 4 4 4 4 1 2 0 0 4 4 4 4 4 4 4 4 4 4 4 4 4 4 4 4 4 4 4 0 0 0 1 2 0 0 0 0 0 0 4 4 4 4 4 4 4 4 4 4 4
4 4 4 4 4 2 1 0 0 4 4 4 4 4 4 4 4 4 4 4 4 4 4 4 4 4 4 4 0 0 0 2 1 0 0 0 0 0 0 4 4 4 4 4 4 4 4 4 4 4
4 4 4 4 4 1 2 0 0 4 4 4 4 4 4 4 1 2 4 4 4 4 4 4 4 4 4 4 0 0 0 1 2 0 0 0 0 4 4 4 4 4 4 4 4 4 4 4 4 4
4 4 4 4 4 0 0 0 0 4 4 4 4 4 4 4 2 1 4 4 4 4 4 4 4 4 4 4 5 5 5 5 5 5 5 5 4 4 4 4 4 4 4 4 4 4 4 4 4 4
4 4 4 4 4 0 0 0 0 4 4 4 4 2 1 2 1 2 1 2 1 2 4 4 4 4 4 4 5 5 5 5 5 5 5 5 5 5 4 4 4 4 4 4 4 4 4 4 4 4
4 4 4 4 4 0 0 0 0 4 4 4 4 1 2 1 2 1 2 1 2 1 4 4 4 4 4 4 5 5 5 5 5 5 5 5 5 5 4 4 4 4 4 4 4 4 4 4 4 4
1 2 1 2 1 0 4 4 4 4 4 4 4 4 4 4 1 2 4 4 4 4 4 4 4 4 4 4 5 5 5 5 5 5 5 5 4 4 4 4 4 4 4 4 4 4 4 4 4 4
2 1 2 1 2 0 0 4 4 4 4 4 4 4 4 4 2 1 4 4 4 4 4 4 4 4 4 4 0 0 0 0 1 2 1 4 4 4 4 4 4 1 2 1 4 4 4 4 4 4
0 0 1 2 0 0 0 4 4 4 4 4 4 4 4 4 1 2 4 4 4 4 4 4 4 4 4 4 0 0 0 0 2 1 2 4 4 4 4 4 4 2 1 2 4 4 4 4 4 4
0 0 2 1 0 0 0 4 4 4 4 4 4 4 4 4 2 1 4 4 4 4 4 4 4 4 4 4 0 0 0 0 1 2 1 4 4 4 4 4 4 2 1 2 4 4 4 4 4 4
0 0 1 2 0 0 0 4 4 4 0 0 4 4 4 4 1 2 4 4 0 0 0 0 0 0 0 0 0 0 0 0 2 1 2 4 4 4 4 4 4 1 2 1 4 4 4 4 4 4
0 0 2 1 2 1 2 1 2 0 0 0 0 0 0 4 4 4 4 4 0 0 0 0 0 0 0 0 0 0 0 0 1 2 1 4 4 4 4 4 4 2 1 2 4 4 4 4 4 4
0 0 1 2 1 2 1 2 1 0 0 0 0 0 0 0 4 4 4 3 3 3 3 3 3 3 3 3 3 0 0 0 0 0 0 4 4 4 4 4 4 1 2 1 4 4 4 4 4 4
0 0 2 1 0 0 0 1 0 0 0 0 0 0 0 0 4 4 4 3 3 3 3 3 3 3 3 3 3 0 0 0 0 0 0 4 4 4 4 4 4 2 1 2 4 4 4 4 4 4
0 0 1 2 0 0 0 2 0 0 0 0 0 0 4 4 4 4 4 4 4 4 4 4 4 4 4 4 4 4 4 4 4 4 4 4 4 4 4 4 4 1 2 1 4 4 4 4 4 4
4 4 4 4 4 4 4 1 2 1 2 1 0 0 4 4 4 4 4 4 4 4 4 4 4 4 4 4 4 4 4 4 4 4 1 2 1 2 1 2 1 2 1 2 1 2 1 2 1 2
4 4 4 4 4 4 4 2 1 2 1 2 0 0 4 4 4 4 4 4 4 4 4 4 4 4 4 4 4 4 4 4 4 4 2 1 2 1 2 1 2 1 2 1 2 1 2 1 2 1
4 4 4 4 4 4 4 0 0 0 0 0 0 0 4 4 4 4 4 4 4 4 4 4 4 4 4 4 4 4 4 4 4 4 0 0 0 0 0 0 0 2 1 0 0 0 0 0 0 0
4 4 4 4 4 4 4 0 0 0 0 0 0 0 4 4 4 4 4 4 4 4 4 4 4 4 4 4 4 4 4 4 4 4 0 0 0 0 0 0 0 1 2 0 0 0 0 0 0 0
4 4 4 4 4 4 4 4 4 0 0 0 0 0 4 4 4 4 4 4 4 4 4 4 4 4 4 4 4 4 4 4 4 4 0 0 0 0 0 0 0 2 1 0 0 0 0 0 0 0
4 4 4 4 4 4 4 4 4 0 0 0 0 0 0 0 0 0 0 0 0 0 0 0 0 0 0 0 0 0 0 0 0 0 0 0 0 0 0 0 0 1 2 0 0 0 0 0 0 0
0 0 0 0 1 2 1 2 1 0 0 0 0 0 0 0 0 0 0 0 0 0 0 1 2 1 2 0 0 0 0 0 0 0 0 0 0 0 0 0 0 2 1 0 0 0 0 0 0 0
0 0 0 0 2 1 2 1 2 0 0 0 0 0 0 0 0 0 0 0 0 0 0 2 7 8 1 0 0 0 0 0 0 0 0 0 0 0 0 0 0 1 2 0 0 0 0 0 0 0
0 0 0 0 1 2 1 2 1 0 0 0 0 0 0 0 0 0 0 0 0 0 0 1 9 10 2 0 0 0 0 0 0 0 0 0 0 0 0 0 0 2 1 0 0 0 0 0 0 0